1111111111111111111
1000001C000000001E1
11111110000000001C1
1P00001110000000001
1000000000000000001
1000000000000000001
1111110100001011111
10100001000010000C1
1C001001000010C01C1
1111111111111111111